111111111
100011001
1000CCC01
1P100CCE1
100000001
111111111