111111111
1VVVVVVV1
1VVVVVVV1
1VVVVVVV1
1VVVV1VV1
111111111
