1111111111111111
1C00010000000011
1000C01110000001
1P000C0000000001
10C001000C000001
10C001000C000001
1C00010000000E01
1111111111111111